##########
####..1..#
#...2..1.#
#.1#21.p.#
#...2..1.#
####..1..#
##########
