#########
#.......#
#.51115.#
#...5...#
###.p.###
#########
