#######
#.....#
#.#1#.#
#..2..#
#.#1#.#
#..p..#
#######
