#######
#.....#
#.#.#.#
#.111.#
#.#.#.#
#..p..#
#######
