##########
#''#''#''#
#'1#''#''#
#'1''q'..#
#'1#''#..#
#''#''#..#
#''''''..#
#''#''#''#
#''#''#''#
##########
