##########
#''#''#''#
#'1#''#''#
#'1''q'..#
#'1#''#..#
#''#'1#..#
#''''1'..#
#'1#''#''#
#''#''#''#
##########
