#################################
#...............................#
#.1..1..1..1...p1....1..1..1..1.#
#...............................#
#################################
