##############
#............#
#.1...p1...1.#
#............#
##############
